10
10
. . . . . . . . . .
. . . . . . . . . .
. . . # . . # . . .
. . . # . . # . . .
. . . # . . # . . .
. . . # . . # . . .
. . . # . . # . . .
. . # . . . . # . .
. . # . . . @ # . .
. . . # # # # . . .